11111111111111111111111111
1CCCCC00000000001000100001
111111C11011110000000101E1
10010000000001000100100011
110000010001010010000C0111
11P00000000100010C10111111
11111111111111111111111111