11111111111111111111111111111
100CCCCC000000000010001000011
10011111C11011110000000101E11
11100100000000010001001000111
10110000010001010010000C01111
11110000010001010010000C01111
11P00000000101000010C10111111
11111111111111111111111111111